κςκ ωπν αζπλ ιησι χνοςνθ μσγθσρ λσθ ζπι ιηγ δςρθι ψγρθπζ ςζ ηςθιπρω θνθψγμιγκ πδ νθςζε γζμρωψιςπζ? τγ ζγςιηγρ. 
κςκ ωπν αζπλ ιησι χνοςνθ μσγθσρ λσθ ψρπξσξοω δονγζι ςζ εργγα? τγ ζγςιηγρ. ς οςαγ ηπλ εργγα μησρσμιγρ οππα ιηπνεη, γυγζ ςδ ς μσζ'ι ργσκ ιηγτ. οσμιδ{ς_ενγθθ_νθςζε_τσζω_εργγα_μησρσμιγρθ_κςκζ'ι_θιπψ_ωπν._λγοο_ψοσωγκ_ς_τνθι_θσω.μπζερσιθ!}


a	σ
b	
c	μ
d	κ
e	γ
f	δ
g	ε
h	η
i	ς
j	χ
k	α
l	o
m	τ
n	ζ
o	π
p	ψ
q	
r	ρ
s	θ
t	ι
u	ν
v	
w	λ
x	
y	ω
z	


οσμιδ{ς_ενγθθ_νθςζε_τσζω_εργγα_μησρσμιγρθ_κςκζ'ι_θιπψ_ωπν._λγοο_ψοσωγκ_ς_τνθι_θσω.μπζερσιθ!}


lactf{i_guess_using_many_greek_characters_didn't_stop_you._well_played_i_must_say.congrats!}


